
R 500 500 

NO ./path_to_the_north_texture

SO ./path_to_the_south_texture

WE ./path_to_the_west_texture

EA ./path_to_the_east_texture

S ./path_to_the_sprite_texture

F 255, 0, 255 

C 255, 0, 255

111111
100001
1011E1
100101
111111