
R 1000 500 

NO ./path_to_the_north_texture

SO ./path_to_the_south_texture

WE ./path_to_the_west_texture

EA ./path_to_the_east_texture

S ./path_to_the_sprite_texture

F 255, 0, 255 

C 255, 0, 255

1111111111111111
110000000000001
1110000002000001
1000000000000001
111000N000000001
1111111111111111