R 1500 1000
WE ./textures/foliage_green.xpm
SO ./textures/ice.xpm 
NO ./textures/bookshelf.xpm
EA ./textures/ice.xpm
S ./textures/seal.xpm
C 140, 195, 207
F 204, 192, 184

111111111111
100000000011
1000000002S1
100000002021
100000000201
100000002021
111111111111