R 1500 1000 
NO ./path_to_the_north_texture
SO ./path_to_the_south_texture
WE ./path_to_the_west_texture
EA ./path_to_the_east_texture

S ./path_to_the_sprite_texture
C 186, 255, 133 
F 142, 230, 74

111111111111
100001000001
100000000001
11000W000011
100000000001
100000000001
100001000001
111111111111