R 1500 1000
WE ./textures/foliage_green.xpm
SO ./textures/ice.xpm 
NO ./textures/bookshelf.xpm
EA ./textures/hay.xpm

S ./path_to_the_sprite_texture
C 140, 195, 207
F 204, 192, 184

111111111
101010101
101010001
101000001
100000001
100000001
100000001
1100N0001
111111111