R 1500 1000 
NO ./path_to_the_north_texture
SO ./path_to_the_south_texture
WE ./path_to_the_west_texture
EA ./path_to_the_east_texture

S ./path_to_the_sprite_texture
C 140, 195, 207
F 204, 192, 184

1111
1001
10W1
1111